#######################################################
#                                                     #
#                                                     #
#                              #                      #
#                             #  #                    #
#                              ##                     #
#             ###############                         #
#                           #                         #
#                           #                         #
#                    <      #                         #
#                           #                         #
#                           #                         #
#                           #                         #
#                                                     #
#                                                     #
#                                                     #
#                                                     #
#                                                    @#
#######################################################
