#######################################################
#                                        #            #
# ###########################            #            #
# #                         #######      #            #
# #                         #    ##      #            #
# #                         #   @##      #            #
# #           ###############  ####      #            #
# #           #             #            #            #
# #           #             #            #            #
# #           #      <      #            #            #
# #           #             #            #            #
# #           #             #            #            #
# #           ##########    #            #            #
# #                     #   ##############            #
# #                     #                             #
# #                     ######################        #
# #                                                   #
#                                                     #
#######################################################
