#######################################################
#                                                     #
#                                                     #
#                                                     #
#                              @                      #
#                                                     #
#             ###############                         #
#                           #                         #
#                           #                         #
#                    <      #                         #
#                           #                         #
#                           #                         #
#                           #                         #
#                                                     #
#                                                     #
#                                                     #
#                                                     #
#                                                     #
#######################################################
