#######################################################
#                                                     #
#                                                     #
#                              #                      #
#                             #@ #                    #
#                              ##                     #
#             ###############                         #
#                           #                         #
#                           #                         #
#                    <      #                         #
#                           #                         #
#                           #                         #
#                           #                         #
#                                                     #
#                                                     #
#                                                     #
#                                                     #
#                                                     #
#######################################################
